1111111111111111111111111111
1000000000000000000000000001
1000000000000000000000000001
1000002000002000020000000001
1000000200002000020022000001
1020000220020000200000000001
1000020020002000022000200001
1020020000000000000000000001
1000000020000002000020002001
1002000000000000000000200001
1000100100100000100101200001
1000100000000000000001020001
1000100000111001110001000001
1000100000100000010001020001
1000100000100000010001000001
1002100000100000010001020001
1000100000111111110001000001
1000100000000000000001000001
1020100000000000000001000001
1000100000000000000001020001
1200111111200000011111000001
1000000000000020000002000001
1002000220002000000000000001
1000000000000000002000000001
1000000000000000000000000001
1000000002000000000000000001
1000002000000200000000200001
1000000000200000000000000001
1000000000000000000000000001
1000000000000000000000000001
1111111111111111111111111111
